XXXXXXX
XXXXPXX
XXPXXXX
XXXXXXP
XPXXXXX
XXXXPXX
XXXSXXX