XXXXXXXXXXXXPXXXXXXXXXXXXXPPXXPXXXXXXXXXXXXXXPXXPX
XXXXXXXXXXXXXXXXXPXXPXXXXXXXXXPPXXPXXXXPXPXXXPPPPP
XXXXXXXXXXPXXXPXPPXXXXXXXXXPXXXXXPXXXXXXXXXXXPXXPX
XXXXXXXXXXXXXXXXXXXXXPPXPXPXXXXXXXXXXXXXXXXXXXPXXX
XXXXPXXXPXXXXXXXPXXXXXXPXXXXXXXPXXXXXXPXPPXXXXXXXX
PXXXXXXXXXXXXXXXXXXXXXPXXXXXXXXXXXPXXXXXXPXPXXXXXX
XXXXXPXXXXXXXXXXXPXPXXXXXXXPXXPXPXPXPXXXXXXXPXXXPX
XXXXXXPXPXXPXXXXXXXXXXXXXXXXPXXXPXXXXXXPXXXXXXXXPX
XXXXPXXXXXXPXXXXPXXXXXXXXXXXXPXXXXXXPXXPXXXPXXXXXX
XXPXPXXXPXXXXXXXXXXXXXXXXPXXXXXPXPXXXPXXXXXXXXXXXX
XXXXXXPXPXXXXPXXPXXXXXXXPPPXXXPXXPXXXXXXPXXXXXPXXX
PPPXPPXXXXPPXXXXPXPXXXXXXXXXXXPXPPXXXXXXXPPXXXXXXP
XXXXXXXPPXXXPXPXXPXXXXXXXXXXXPXXXXXXXXXXPXXXXXXXXX
XXXXXXXPPXXXXXXXXXXXXXXXXPXXXXXXPXXXXXXXXXXXXXPXXX
XXXPXXPXXXXXPXPXXXXXXXXXXXPXXXXXXXPXXXXXPXPXXXXXPX
XXXXXXXXXXXXXXXXXXXXXXXXXXXXPXXXXXXXXXPPXXXXXPXXXX
XXXXPXXXXPPPXXXXXXXXXXXXPXPPXXXXXPXXXXXXXXXXPXXXPX
PXXXXXXXXXXXXXXXPXXXXXXXXPXPXXXXPXXXXXXXXXPXXXXPXX
XXXXXXXXXXXXXPXXXXXXXXXXXXPXPPPXXXXXXXXXXXXPXXXXXX
XXPXXPXXXXPXXPXXXXPXXXXXXXXXXXXXXPXPXXXXXXPXXXXPXX
XPXXXPXXXXXXXXXPXXXXXPXXXXXXXPXXXPPPXXXXXXXXPPXXPX
XXXXXXXXXPXXPXXXPXXXXXXXXXPXXXXXPXXPPXXXXPXXXXXXPP
XXXXPXXXXXXXXPPXXXXXPXXXXPXXXXXXXXXXXPXXXXXXXXXXXX
XXXXPXXXXPPXXXXXXXPXXXXXXXXXXXXXXXXXXXXXXXPXXXXXXP
XXXPXXXXXXXPXXXXXPXXXXXXXXXPXXXXXXXXXPXXXXXXPXXXXX
XXXXXPXPXXXXXXXXXXXXXPXXXXXPPXXXXXXXPPXXXXXXXXXXPX
XXXXXXXXXXXPPXPXXXXXXXXXXXPXXPXXXXXPXXXXXXXXXXXXXX
PXXPXXXXXXXXPXXXXXXPXXXXXXXXXXXXXXXXXXPXXXXXXXPPXX
XXXPXPXXXXXXXXPXXXXXXXXXXXXXXXXXXXXXXXXXPPPXXXXXXX
PXXXXXXXPPXXXXXXXXXXPXXXPXXXPXXXXXPXXPXXXXXXXXXXXX
XXXPPXXXXPXXXXXXXXXPXXXXXXXXXXPXXXXXPXPXXXXPXXXPXX
XXXXPXXXPXXPXXXXPPXXXXXXXPXPXXXXPXPXXXXXXXXXXPXXXX
PPXPXXXXXXXXXXXXXXPXXXXPPXXXXPXPPPXXPPXXXXXXXPXXXX
XXXXXXXPXXXPXPXXXXPXXPXPXXXXXPPXXXXXXPPXPXXXXXXXXX
XPXXXXPXXPXXXXXPXXXXXXPXPPPPXXPXXXXXXPXXXXXXXXXXXX
PXXXPXXXXXXPXXXXPXXPXXXXXXXXXXXXXXXXXPXXXXPXXXXXXX
XXXXPXXXPXXXXXXXXXXXXPXXXXXXXXXXXXPXXXPPXXXXXXXXPX
PXPXXXXXXXPXXXXXXPXXPXXXXXXXXXXXPXPXPPXPXXXPPXXXXX
XXXXXXXXXXPXXXXXPXXXXXXXXXXXXXXXXXXXXXXXPXXXXPXXXX
XXXXXXXXXXXXXXXXXXXXXPXXXXPPXXXXPXXXXXXXXXXXXXXXXX
PXXPXXXXPPPXXXPXXXXXXXXXXXPXXXXXXPXXPXXXXXXXXXXXXX
XXXXXXXXXXXXPXXXXXXXXXPPXXXPXXXXPXXPXXPPXPXXXXXXXX
XPXXXXXXPXXXXXXPXXXPXXXPXXXXPXXXXXPXXXXXXXXXXPXXXX
XPXXXXXXXXXPXPXXXXXXXPXXXXXXXXXXXXXXXXXXXXXXXXXXXX
XXXPXPXXXXXXPXPXXXXXXPXXXXXXXXXXXXXXXXXPPXXXXXPPXX
PXXXXXPXXXXXXXXXXPXXXXXXXXXXXXSXXXPXXPPXXXXXXXXXXX
XXXXPXPXXXXXXXXXPXXPXXXXXXXXXXPXPXXXPPXXXXPXXXXXXX
XXXXPXXXPXXXXXXPXXPXPXXXXXXXXXXXXXXXXXXXXXXPXXXXXX
XXXXXXXXXXXXXXXPXXXXXXXXXXXPXXXXPXXXXXPXXXPXXXXPXX
XXXXXXXPXXXXXPXXXXXXXXXXXXXXXXXXXPXXXXXXXXXXXXXXXX
