XXXXXXPXXXXXXXXXXXXPXXXXXPXXXXXXPXXPXXXXXXXXXXXXXP
XXXXXPXXXXXXXXXXXXXXPXXXXPXXXXSPXXXPXPXXXXXXXXPXPX
XXXXXXXXXXPXPXXXXXXXXXXXPXXXXXXXXXXPXXXXXXXPXXXXXX
XPXXXXXXPXXXXXXXXXXXXXXXXXXXXXPXXXXXPXPXXXXXXXXXXX
XPXXXPXXXXXXXXPPXXXPXPPXXXXXXXXXXXXXXXPXXXXXXXXPPX
XXXXXXPPXXXXXXXXXXPXXXXXXXXXXXXXXPXXPXPXXXPXPXXXXP
XXXPXPXXXXXXXXXXXXXPXXXXXXPXPXPXXXXXXPXPXXXXXPXXXX
PXXPXXXXXXXXXXXPPXXXXPXXXPXXXXXXXXXPXPXPXPXXXPPXPX
PXXXXPXPPXXXXPPXXXXXXXPPXXXXXXPXXXXXXXXXPXPXXXXXPX
XXPXXXPPXXXXPPXXXPXXXXXXXXPXXXXXXXXPXXPXXXXPXXXXXX
XXXXXXXXXXXXXPXXXXXXXXXXXXXXXXXXXXXXXXXXXXXPXXXXXX
PXXXPXXXXXXXXXXXXPXXXXXXXXXXXXXXXXXXXXXXXXXXXXXXXX
XXPPXXXXXXXXXXXXXXXXXXXXXXXXXXXXXXXXXXXXXXXXXXXXXX
XXXXXXXXXXXXXXXXPXXXXXXXXXXXXPXXXXXXXXXXXPXXXXXXXP
XXXXXXXXXXPPXXXXXXXXPXPXXXXXXPXXXXXXXXXXXXXPXXXXXX
XPXXXXXXXXXXXPXXXPXXPXXXXXXXXXXXXXXXPXXXPPXXPXXXXX
XXXXPXXXXXXXPPPXPXXXXXXXXXXXXXXXXXXXXXXXPXXXXXXXXX
XPXXXPXXPXPXPXXXXXXXXPPXXXXXXXXXXXPXXPPPXXXXXXXXXX
XXPPXXXXXXXXXPXXXXXXXXXXPPPXXPXXXXXXPXXXXXXXXXPXXX
XXXXXXXXXXXXXXXXXXPXPXXXPPXXXXPXXPXXXXXXXXXXPXXXXX
PPXXXXXXXXXXXXPXXXPXPXXXXXXPXPXXXXXXXXXXXXXXPXPXXX
XPXXXXPXXXXXXXXXXPXXPXXXXXXXXXXXXXXXXXXXXXXXXPXXXX
XXXXXXXXXXXXXXXXXPXPXXXPPXPXXXXXXXXXXPXPXXXXXXXXXX
XXXPPPXPXXPXPXXXXXXXXXXXXXXXPPXXXXXXXXPXXPXXXXPXXX
XXXPXXPXXXXXXXXXXXXXXXXXXXXPXXXXXXXXPXXXXXXXXXPXXX
XXXXXXXXXXXXXXXXXPXXXXXPPXXXXXXXXXXXXXXXPXXXXXXXXX
XXXXPXXXXXXXXXXXXXXXXXXXXXXXXPXXXXXXXXXXXPXXPXXXXP
PXXXXPXXXXXXXXXXPXXXPXXXXXXXXPXXXXXXXXXXXXXPXXXXXX
PXXXXXXXPXXXXXXXXPXXXXPXXXXXXXXPXXXXXXXXXXXXPXXPPP
XPXXXXXXXXPXXXPXXXXXXPXXXXXXXXPPXXXXXXXXXXXXXXXXPX
XXPPXXPXXXXXXPXXPXXXPXXXXXPPXXXXXXXXXXXXXXXXXPXXPX
XPPXXXXXXPXXXXXXPXPXXXXPPXXXXXXXPXXXXXXXXXXXPXXXXX
XXXXXXXXXXXXXXXXXXXXXXXXXXXXXXXXPXXXXXPXXXXXPPXXXX
XXXPXXXPXXXXPXXPXXXXXXXXXXXXXXXPXXXXXXXXXPPXXXXXXP
XXPXXXXXXXXXXXXXXXXXXXXXXXXXXXXXXXXXXXXXXXXXPXXXXX
XXXPXXXPXXXXPXXXXXXXXXXXPXXXXXXXXXXXXXXPXXXXXXXXXX
PPXXXPXXXXXXXXXXXXXXXXPXXXPXXXXPPXXXXXXXXXXXXPXXXX
XXXXXXXXXXXXXXXXXXXXPXXXXXXXXXPXPXXXXXXXXXXPXPXXXX
PPXXXXXXXXXPXXXXXXXXXXXXPXXPXXXXXPXPPXXPPXXXXPXXXP
XXXXXPXXXXXXXXXXXXXXXXXXXXXXXPPPXXXXXXPXXPXXXPXXXX
XXXXXXPXXXXXXXXXPXXXXXXXXXPXXXXXXPXPXXXXPXXXXPXXXX
XXXPXPXXXXXXXXXXXPXXXXPPXXXXXXXXXXXXXPXXXXXPXPXXXP
PXXPXXXXXXXPXXXXXXXPXXXXXXPPXXXXXXXXXXXXXXXXXXXXXX
PXPXXXXXXXXXXXXXXPXXXPXXXXXXPXXXXXXXXXXXXPXXPXXXXX
XXXXXXXPXXXPXXXXXXPXXXXXXXXXXXXXXXXXXXXXXXXXXXXXXX
XXXPXXXXXXXXXXXXXXXXXXXXXPXXXXPPXXXXXXXXXXXXXXXPXX
XXXXXXXXXXXXXXXXXXXXXXXPXXPXXXXPXXPXXXXXXXXXXXXXXX
XPXPPXXXXXPXXXXXXXXXXXXXXPXXXXXXXXXPXXXXXXXXXPXXXX
XXXXPXXXXXXXXXPXXXXXPXXXPXXXXXXXXXXXXXPXXXXXXXXXXX
PXXXXXXXXXXXXXXXXXXXXXXXXPXPXXXXXPXXXXXXXXXXXXXXXX
