XXXXXX
XXXXXX
XPPXXX
XXXXXX
XXXXXX
XXXPSX
