XXXXXPXXXX
XXXXXXXPXP
XSXXXXXXXX
XXXXXXXPXX
XXXXXXXXXP
XXXXXXXXXX
XPXXPXXXXX
XXXXXXPXPX
XXPXXXXXXP
XPXXXXXXXX
